5
0 3
3 0 0 0 4 0 
1 3
4 1 1 0 3 1 
2 3
0 1 1 1 3 2 
3 3
0 2 2 0 4 2 
4 3
1 2 3 2 4 2 
